EA ./ressources/textures/creepy/EA.xpm
F 0, 0, 0

SO ./ressources/textures/creepy/SO.xpm
C 0, 0, 0
WE ./ressources/textures/creepy/WE.xpm
NO ressources/textures/creepy/NO.xpm


11111111111111111111111111111111111111111111111111111111111111111111111111111111111111111111111111111111111111111111111111
11111111111111111111111111111111000000000000000000000000000011000000000000000000000000000011000000000000000000000000000011
10000000000000000000000000000111000000000000000000000000000011000000000000000000000000000011000000000000000000000000000011
10000000000111000000000000000000000000000000000000000000000100000000000000000000000000000000000000000000000000000000001111
10000100000000000000000000000000000000000000000000000000000000000000000000000000000000000000000000000000000000000000000001
11111111111111111111111111111111000000000000000000000000000011000000000000000000000000000011000000000000000000000000000011
10000000000000000000000000000111000000000000000000000000000011000000000000000000000000000011000000000000000000000000000011
10000000000111000000000000000000000000000000000000000000000100000000000000000000000000000000000000000000000000000000001111
10000100000000000000000000000000000000000000000000000000000000000000000000000000000000000000000000000000000000000000000001
11111111111111111111111111111111000000000000000000000000000011000000000000000000000000000011000000000000000000000000000011
10000000000000000000000000000111000000000000000000000000000011000000000000000000000000000011000000000000000000000000000011
10000000000111000000000000000000000000000000000000000000000100000000000000000000000000000000000000000000000000000000001111
10000100000000000000000000000000000000000000000000000000000000000000000000000000000000000000000000000000000000000000000001
11111111111111111111111111111111000000000000000000000000000011000000000000000000000000000011000000000000000000000000000011
10000000000000000000000000000111000000000000000000000000000011000000000000000000000000000011000000000000000000000000000011
10000000000111000000000000000000000000000000000000000000000100000000000000000000000000000000000000000000000000000000001111
10000100000000000000000000000000000000000000000000000000000000000000000000000000000000000000000000000000000000000000000001
11111111111111111111111111111111000000000000000000000000000011000000000000000000000000000011000000000000000000000000000011
10000000000000000000000000000111000000000000000000000000000011000000000000000000000000000011000000000000000000000000000011
10000000000111000000000000000000000000000000000000000000000100000000000000000000000000000000000000000000000000000000001111
10000100000000000000000000000000000000000000000000000000000000000000000000000000000000000000000000000000000000000000111111
11111111111111111111111111111111000000000000000000000000000011000000000000000000000000000011000000000000000000000000000011
10000000000000000000000000000111000000000000000000000000000011000000000000000000000000000011000000000000000000000000000011
10000000000111000000000000000000000000000000000000000000000100000000000000000000000000000000000000000000000000000000001111
10000100000000000000000000000000000000000000000000000000000000000000000000000000000000000000000000000000000000000000000001
11111111111111111111111111111111000000000000000000000000000011000000000000000000000000000011000000000000000000000000000011
10000000000000000000000000000111000000000000000000000000000011000000000000000000000000000011000000000000000000000000000011
10000000000111000000000000000000000000000000000000000000000100000000000000000000000000000000000000000000000000000000001111
10000100000000000000000000000000000000000000000000000000000000000000000000000000000000000000000000000000000000000000000001
11111111111111111111111111111111000000011111111000000000000011000000000000000000000000000011000000000000000000000000000011
1000000000000000000000000000011100000000110S11000000000000110000000000000000000000000000110000000000000000000000000000111
100000000001110000000000000000000000000001001000000000000000100000000000000000000000000000000000000000000000000000000001111
1000010000000000000000000000000000000000110110000000000000000000000000000000000000000000000000000000000000000000000000001
111111111111111111111111111111110000000011011000000000000000110000000000000000000000000000110000000000000000000000000000111111111111111
1000000000000000000000000000011111111111100111111111111111110000000000000011000000000000000000000000000011000000000000000000000000000011
100000000001110000000000000000000000000010110000001000000001000000000000000000000000000000000000000000000000000000000011111111111111111
10000100000000000000000000000000000000001000000000000000000000000000000000000000000000000000000000000000000000000000000001
11111111111111111111111111111111011111111011000000100000000011000000000000000000000000000011000000000000000000000000000011
10000000000000000000000000000111000000000011000000100000000011000000000000000000000000000011000000000000000000000000000011
10000000000111000000000000000000011111101011000000100000000100000000000000000000000000000000000000000000000000000000001111111111
10000100000000000000000000000001111111110011111111111111111100000000000000000000000000000000000000000000000000000000000000000001
11111111111111111111111111111111000000000000000000000000000011000000000000000000000000000011000000000000000000000000000011111111
10000000000000000000000000000111111111111111111100000000000011000000000000000000000000000011000000000000000000000000000011
10000000000111000000000000000000000000000000000000000000000100000000000000000000000000000000000000000000000000000000001111
1000010000000000000000000000000000000000000000000000000000000000000000000000000000000000000000000000000000000000000111111
11111111111111111111111111111111000000000000000000000000000011000000000000000000000000000011000000000000000000000000000011
10000000000000000000000000000111000000000000000000000000000011000000000000000000000000000011000000000000000000000000000011
10000000000111000000000000000000000000000000000000000000000100000000000000000000000000000000000000000000000000000000001111
10000100000000000000000000000000000000000000000000000000000000000000000000000000000000000000000000000000000000000000000001
11111111111111111111111111111111000000000000000000000000000011000000000000000000000000000011000000000000000000000000000011
10000000000000000000000000000111000000000000000000000000000011000000000000000000000000000011000000000000000000000000000011
10000000000111000000000000000000000000000000000000000000000100000000000000000000000000000000000000000000000000000000001111
10000100000000000000000000000000000000000000000000000000000000000000000000000000000000000000000000000000000000000000000001
11111111111111111111111111111111000000000000000000000000000011000000000000000000000000000011000000000000000000000000000011
10000000000000000000000000000111000000000000000000000000000011000000000000000000000000000011000000000000000000000000000011
10000000000111000000000000000000000000000000000000000000000100000000000000000000000000000000000000000000000000000000001111
10000100000000000000000000000000000000000000000000000000000000000000000000000000000000000000000000000000000000000000000001
11111111111111111111111111111111111111111111111111111111111111111111111111111111111111111111111111111111111111111111111111

