F 		25, 240  , 200


SO			 ./ressources/textures/SO.XPM


                  NO          ./ressources/textures/NO.XPM


EA	 		 		 	 	 	     	  	 	 	  	 	 	 	 	  ./ressources/textures/EA.XPM
C	 		 	255, 200, 1

				   WE				        ./ressources/textures/WE.XPM


111
111111111111111111111111111111
11111111100000011101000000011111
11000000000000000000000100001
11111111100000000000000100001
11000000000000000000000100001
11010000N00000010000000100001
11000000000000000000000100001
11000000010000000000000100001
11110011000010111111110111101
11111111111111111111111111111111111