F 		25, 240  , 200


SO			 ./ressources/textures/test


                  NO          ./ressources/textures/test


EA	 		 		 	 	 	     	  	 	 	  	 	 	 	 	  ./ressources/textures/test
C	 		 	255, 200, 1

				   WE				        ./ressources/textures/test


111
111111111111111111111111111111
10001000000000000000000000001
10001000000000000000000000001
10001000000000000000000000001
10W00010000000000000000000001
11111111111111111111111111111111111