F 		25, 240  , 200


SO			 ./ressources/textures/SO.XPM


                  NO          ./ressources/textures/NO.XPM


EA	 		 		 	 	 	     	  	 	 	  	 	 	 	 	  ./ressources/textures/EA.XPM
C	 		 	255, 200, 1

				   WE				        ./ressources/textures/WE.XPM


1111111111111111111111111111111
1000000000000000000000000000011
10000000000111000000000000000001
1000000000000100000000000000001
1000000000000000000000000000001
1000000000000000000000000000001
1000000000000000000000000000001
1000000000000000000000000000001
1000010000000000000001000000001
1000010000000E00000000000000001
1000010000000000000001000000001
1000010000000000000000000000001
1000000000000000000001000000001
1000000000000000000000000000001
1000000000000000000000000000001
1000000000000000000000000000001
1000000000100001000000000000001
1000000000000000000000000000001
1111111111111111111111111111111