F 		25, 240  , 200


SO			 ./ressources/textures/test


                  NO          ./ressources/textures/test


EA	 		 		 	 	 	     	  	 	 	  	 	 	 	 	  ./ressources/textures/test
C	 		 	255, 200, 1

				   WE				        ./ressources/textures/test


111
111111111111111111111111111111
11000000000111010000000100001
11110011000010111111110111101
1111111111111101111111111111111
1111111111110001111110S010011
11111111111111111111111111111111111