F 		50, 170  , 100


SO			 ./ressources/textures/test


                  NO          ./ressources/textures/test


EA	 		 		 	 	 	     	  	 	 	  	 	 	 	 	  ./ressources/textures/test
C	 		 	0, 170, 200

				   WE				        ./ressources/textures/test


1111111111111111111111111111111
1000000000000000000000000000011
10000000000111000000000000000001
10000000000001000000000000000011111
10000000000000000000000000000010011
10000000000000000000000000000011111111111111111111111
10000000000000000000000000000011111111111111111111111
10000000000000000000000000000011111111111111111111111
10000000000000000000000000000011111111111111111111111
10000100000000000000010000000011111111111111111111111
1000010000000N00000000000000001
1000010000000000000001000000001
1000010000000000000000000000001
1000000000000000000001000000001
1000000000000000000000000000001
1000000000000000000000000000001
1000000000000000000000000000001
1000000000100001000000000000001
1000000000000000000000000000001
1111111111111111111111111111111