EA ./ressources/textures/mgs/NO.xpm
C 7,0,88
SO ./ressources/textures/mgs/SO.xpm
F 255,250,250
WE ./ressources/textures/mgs/EA.xpm
NO ressources/textures/mgs/WE.xpm


1111111111111111111111111111111
1000000000000000000000000000011
1000000000000000000000000000001
1000011111111000000000011111111
100000011111111000001111111111
100000000111111100000000001111111
10000000000000000000000000000011111
100000000000011111111000000000011
100000000000001111111100000111111111
10000000000000001111111000000000011
10000000000000000000000000000011111
10000000000000000000000000000011111
10000000000000000000000000000011111
10011111110000010000000000000010011
100110000001001000000000000011111111111111111111111
1111101111111000111111111111111111111111111111
1000101111110000001111100000000000011111111111111111111111
10011010000000000000000000000011111111111111111111111
100100000000111110000000000000000011111111111111111111111
1001000000001000100000000000000011111111111111111111111
100100000000110010000000000000001
100000000000100010000000100000011
100100000000010010000000100000001
10010000000000000000000000000001
100100000000000000000000000000011
1001000000000000000000001000000101
1001000000000000000000001000000101
100100000000000000000000000000011
100100000000000000000000000000011
1001000000000000000000001000000101
1001000000000000000000001000000101
100100000000000000000000000000011
10010000011111111100000000000001
10010000010000000100000000000001
10010000010000000100000000000001
10010000010000000100000000000001
10010000010111110100000000000001
10010000000000000000000000000001
10010000000000000000000000000001
11110000000000000000000000000001
10000000000000000000000000000001
10000000111110000000000000000001
11110000111110000000000000000001
111E0000000000000000000000000001
1111111111111111111111111111111
